    #
  ## ##
 #     #
#   #   #
#   #   #
#   #   #
 #   #O#
  # P #
 # #   #
#   #   #
# X #   #
#   #   #
 #     #
  ## ##
    #